#### ####
# d     #
# ## ## #
# #  # #
    #    
# d  p  #
# ##### #
#   d   #
#### ####
