#### ####
# d     #
# ## ## #
# #  #  #
    #    
# d  p  #
# ##### #
#   d p #
#### ####
