#### ##############                 #################################
# d     # #   # ## #   # #  # #   # # # #   # #   # #   # # # #   # #
# ## ## #     # #   d   # #   d   ##   d   ##   d   # #   d   ##   d#
#               #   #     #       ##       #  #      #  #   #       #
#               #   #     #       ##       #  #      #  #   #       #
#               #   #     #       ##       #  #         #   #       #
#               #         #       ##       #  #      #  #   #       #
#        d      #   #     #                #  #      #      #       #
#                   #     #       ##       #  #      #  #   #       #
#               #   #     #       ##    d  #  #      #  #           #
#               #   #     #       ##       #  #      #  #   #       #
#               #   #     #       ##       #  #      #  #   #       #
#               #   #     #       ##       #  #         #   #       #
                #         #       ##       #  #      #  #   #        
#        d      #   #     #                #  #      #      #       #
#                   #     #       ##       #  #      #  #   #       #
#               #   #     #       ##    d  #  #      #  #           #
#               #   #     #       ##       #  #      #  #   #       #
#               #   #     #       ##       #  #      #  #   #   p   #
#               #   #     #       ##       #  #         #   #       #
#               #         #       ##       #  #      #  #   #       #
#        d      #   #     #                #  #      #      #       #
#                   #     #       ##       #  #      #  #   #       #
                #   #     #       ##    d  #  #      #  #            
#               #   #     #       ##       #  #      #  #   #       #
# d     # #   # ## #   # #  # #   # # # #   # #   # #   # # # #   # #
# ## ## #     # #   d   # #   d   ##   d   ##   d   # #       ##    #
#               #   #     #       ##       #  #      #  #   #       #
#               #   #     #       ##       #  #      #  #   #       #
#               #   #     #       ##       #  #         #   #       #
#               #         #       ##       #  #      #  #   #       #
#        d      #   #     #                #  #      #      #       #
#                   #     #       ##       #  #      #  #   #       #
#               #   #     #       ##    d  #  #      #  #           #
