#####################################################################
#  d                                                                #
#                                                                   #
#                                                                   #
#                                                                   #
#                                                                   #
#                                                                   #
#                                                                   #
#                                                                   #
#                                                                   #
#                                                                   #
#                                                                   #
#                                                                   #
#                                                                   #
#                                                                   #
#                                                                   #
#                                                                   #
#                                                                   #
#                                                                   #
#                                                                   #
#                                                                   #
#                                                                   #
#                                                                   #
#                                                                   #
#                                                                   #
#                                                                   #
#                                                                   #
#                                                                   #
#                                                                   #
#                                                                   #
#                                                                   #
#                                                                   #
#                                                                   #
#                                                                   #
#                                                                   #
#                                                                   #
#                                                                   #
#                                                                   #
#                                                                   #
#                                                                   #
#                                                                   #
#                                                                   #
#                                                                   #
#                                                                   #
#                                                                   #
#                                                                   #
#                                                                   #
#                                                                   #
#                                                                   #
#                                                                   #
#                                                                   #
#                                                                   #
#                                                                   #
#                                                                   #
#                                                                   #
#                                                                   #
#                                                                   #
#                                                                   #
#                                                                   #
#                                                                   #
#                                                                   #
#                                                                   #
#                                                                   #
#                                                                   #
#                                                                   #
#                                                                   #
#                                                                   #
#                                                                p  #
#####################################################################
