#### ####
# d     #
# ## ## #
# #   # #
    #    
# d p   #
# ##### #
#   d   #
#### ####
