#####  ######
#  p        #
#           #
#    ###     
     #d#     
#    ###     
#           #
#           #
###### ## ###
